W1 ../../textures/wall1.png

R ../../textures/doorR.png
RE ../../textures/doorRedge.png

F ../../textures/floor_128.png
C ../../textures/ceil_128.png

111111111111
100E00100001
111111R11111
100000100001
111111111111
