W1 textures/wall1.png
R textures/doorR.png
L textures/doorL.png
T textures/doorT.png
RE textures/doorRedge.png
LE textures/doorLedge.png
TE textures/doorTedge.png
F textures/floor_128.png
C textures/ceil_128.png

11111111111111111111111111111111111111
10000000000000000000000000000000000001
10000000000000000000000000000000000001
10011R1L1T1LR1RL1RR1LL1RTR1LTL1TTT1001
10010000000000000000000000000000001001
100R000000000000000000000000000000R001
10010000000000000000000000000000001001
100L000000001TTTTTTTTTTT1000000000L001
100100000000T00000000000T0000000001001
100T00000000T00000000000T000000000T001
100100000000T00000000000T0000000001001
100L00000000T00000000000T000000000L001
100R00000000T00000000000T000000000R001
1001000000001TTTTTTTTTTT10000000001001
100R000000000000000000000000000000R001
100L0000R000000000T0000000000L0000L001
1001000R0R0000000T0T00000000L0L0001001
100R0000R000000000T0000000000L0000R001
100R000000000000000000000000000000R001
1001000E00000RR000TT000LL0000000001001
100L000000000000000000000000000000L001
100L000000R00000000000000000R00000L001
1001000000R000R0000T0000L000R000001001
100R000000000R1R00T1T00L1L00000000R001
100T0000000000R0000T0000L000000000T001
100R000000T00000000000000000T00000R001
1001000000T000R100000001L000T000001001
100L000000000R1R0000000L1L00000000L001
100T0000000001R0001T1000L100000000T001
100L000000L0000000T1T0000000L00000L001
1001000R10L00000001T10000000L000001001
100T000000000000000000000000000000T001
100T000000000RR000TT0000LL00000000T001
100T000000000000000000000000000000T001
10010000000000000000000000000000001001
10011R1L1T1LR1RL1RR1LL1RTR1LTL1TTT1001
10000000000000000000000000000000000001
10000000000000000000000000000000000001
11111111111111111111111111111111111111