SO asset/tex/Stone/stone wall 2.jpg
NO asset/tex/Stone/stone wall 2.jpg
WE asset/tex/Stone/stone wall 2.jpg
EA asset/tex/Stone/stone wall 2.jpg

F 40,72,24
C 40,26,24

1111111111111111111111111111111111111111111111111111111
1000000000110000000000000000000000000000000000000000001
1011000001110000000000000000000000110000000000000000001
10W1000000000000000000000000011001111111000000000000001111111111111
1111111110000000011100000000000011111111111100000000000000000000001
1000000000110000011101111111111110000000000000000000001111111110001
1111011111111001110000001000000110000000111111111111111       10001
1111010000000000001010000001011111111000000000000000001 11111110101
1100000001010100000000001000100000000011111000000000001 10000000001
1000001000000000000000001000100000001000000000000000001 10001111111
1000100000000000000101001000100000000111111111111111111  101
1100000111010101111101111000111111110000000000000000001  101
1111011111110001110111110100010000000000000000000000001  101
1000000000000100000000000000000000011000000000000000001  101
1000000000000111111111111111111111111111111111111111111  101
1000000000000000000000000000000000000000000000000000001  101
1011111111111111111100000010100000000000000000000000001  101
1000000000000000000000001000100000000000000000000000001  101
101111110000000000111111111111111111111111111111111111111101111111111111111111111111111111111
100000000000000000000000000000000000000000000000000000000000000000000000000000000000000000001
101111111111111111100000000000000000000111111111111111100000000000000000000000000000000000001
100000000000000000000000000010000000000000000000000000000011000011000011000011000011000011001
111111111111111111111111111111111111111111111111111111100011000011000011000011000011000011001
                                                      100000000000000000000000000000000000001
                                                      100000000000000000000000000000000000001
                                                      100011000011000011000011000011000011001
                                                      100011000011000011000011000011000011001
                                                      100000000000000000000000000000000000001
                                                      100000000000000000000000000000000000001
                                                      111111111111111111111111111111111111111