SO ROCKSO.bmp
NO ROCKNO.bmp
WE ROCKWE.bmp
EA ROCKEA.bmp

F 250,250,0
C 0,0,250

11111
10001
10N01
10001
11111