W1 ../../textures/wall1.png
F ../../textures/floor_128.png
C ../../textures/ceil_128.png

11111111111111111111111111111111111111
10000000000000000000000000000000000001
10000000000000000000000000000000000001
10011R1L1T1LR1RL1RR1LL1RTR1LTL1TTT1001
10010000000000000000000000000000001001
100R000000000000000000000000000000R001
11111111111111111111111111111111111111