W1 ../../textures/wall1.png
F ../../textures/floor_128.png
C ../../textures/ceil_128.png

SP ../sprites/coin_ys_gold.png
[-4294967291.0;1.5]
[-4294967292.0;1.5]
[-4294967293;1.5]
[4294967299;3.5]
[4294967300.5;3.5]

1111111111
1000000001
1E00000001
1000000001
1111111111
