W1 ../../textures/wall1.png
F ../../textures/floor_128.png
C ../../textures/ceil_128.png

SP ../sprites/coin_ys_gold.png
[3.5.5.5;1.5]
[4.5;2.5.5]
[5.5.0.5.1.2.3..1...1.75.7...;3.5.5]

1111111111
1000000001
1E00000001
1000000001
1111111111
