SO colorstone.png
NO greystone.png
WE mossy.png
EA wood.png
F 12,161,95
C 142,209,209

111111111111111111111111111111111111111111111
1000000000000000000000E0000000000000000000001
100111111111110111111000111111011111111111001
100111111111110111111000111111011111111111001
100000000000110110000000000011011000000000001
100110011100110110000111000011011001110011001
100110011100110110001000100011011001110011001
100110011100110000000000000000011001110011001
100110000000111111100010001111111000000011001
100111111100111111100000001111111001111111001
100111111100000001100010001100000001111111001
100000001100111001100000001100111001100000001
100111001100111001100010001100111001100111001
100111001100111001100000001100111001100111001
100111001100000001111111111100000001100111001
100000001111111001111111111100111111100000001
100000001111111000000010000000111111100000001
100111000000011001110010011100110000000111001
100111001110011001110010011100110011100111001
100111001110011001110010011100110011100111001
100000000000011000000010000000110000000000001
100111111110011111110000011111110011111111001
100000000000000000000000000000000000000000001
111111111111111111111111111111111111111111111
