SO texture_south.png

NO texture_north.png
WE texture_west.png


EA texture_east.png

F 0,255,0
C 0,0,255

        1111111111111111111111111
        1000000000110000000000001
        1011000001110000000000001
        1001000000000000000000001
111111111000000001100000000000001
100000000011000000110111111111111
11110111111110011100000010000001
1111010000000000001010000001011
11000000010101000000000010001
1000001000000E000000000010001
10001000000000000001010010001
11000001110101011111011110001
11110111 1110101 101111010001
11111111 1111111 111111111111
