SO asset/tex/Quake/TECH30.bmp
NO asset/tex/Quake/TECH30.bmp
WE asset/tex/Quake/TECH30.bmp
EA asset/tex/Quake/TECH30.bmp
C 20,25,40
F 20,20,25


10111
10001
10N01
10001
11111
