NO ./textures/wall_N.png
SO ./textures/wall_S.png
WE ./textures/wall_W.png
EA ./textures/wall_E.png

F 220,100,0
C 225,30,0

11111
1e0N1
11111
