SO textures/ROCKSO.bmp
NO textures/ROCKNO.bmp
WE textures/ROCKWE.bmp
EA textures/ROCKEA.bmp

F 50,0,30
C 0,50,30

1111111111
1000000001
1000N00001
1000000001
1111111111
