SO textures/ROCKSO.bmp
NO textures/ROCKNO.bmp
WE textures/ROCKWE.bmp
EA textures/ROCKEA.bmp
C 20,25,40
F 20,20,25


11111111111
10000000001
100000
10N001
11111
