NO ./textures/wall1.jpg
SO ./textures/wall2.jpg
WE ./textures/wall3.jpg
EA ./textures/wall0.jpg

F 220,100,0,
C 225,255,0,

11111
10001
10N01
10001
11111
