SO 15.jpg
NO 16.jpg
WE 17.jpg
EA 18.jpg

C 40,35,35
F 20,20,25

1111111111111111111111111111111111111111111111111111111
1000000000110000000000000000000000000000000000000000001
1011000001110000000000000000000000110000000000000000001
1001000000000000000000000000011001111111000000000000001111111111111
1111111110000000011100000000000011111111111100000000000000000000001
1000000000110000011101111111111110000000000000000000001111111110001
1111011111111001110000001000000110000000111111111111111       10001
1111010000000000001010000001011111111000000000000000001 11111110101
1100000001010100000000001000100000000011111000000000001 10000000001
1000001000000000000000001000100000001000000000000000001 10001111111
1000100000000000000101001000100000000111111111111111111  101
1100000111010101111101111000111111110000000000000000001  101
1111011111110001110111110100010000000000000000000000001  101
1000000000000100000000000000000000011000000000000000001  101
1000000000000111111111111111111111111111111111100001111  101
1000000000000000000000000000000000000000000000000000001  101
1011111111111111111100000010100000000000000000000000001  101
1000000000000000000000001000100000000000000000000000001  101
10111111000000000011111111011111111111111111111111111111110111111111111111111111111111111111111111111111111111111111111111111111111111111111111111111111111111111111111
100000000000000000000000000000000000000000000000000000000000000000000000000000000000000000001000000000000000000000000000000000000000000000000000000000000000000000000001
101111111111111111100000000000000000000111111111111111100000000000000000000000000000000000001000000000000000000000000000000000000000000000000000000000000000000000000001
100000000000000000000000000010000000000000000000000000000011000011000011000011000011000011001000000000000000000000000000000000000000000000000000000000000000000000000001
111111111111111111111111111011111111111111111111111111100011000011000011000011000011000011001000000000000000000000000000000000000000000000000000000000000000000000000001
                          101                         100000000000000000000000000000000000001000000000000000000000000000000000000000000000000000000000000000000000000001
                          1011111111111111111111111111100000000000000000000000000000000000001000000000000000000000000000000000000000000000000000000000000000000000000001
                          1000000000000000000000000000100000000000000000000000000000000000W00000000000000000000000000000000000000000000000000000000000000000000000000001
                          1000000000000000000000000000100000000000000000000000000000000000001000000000000000000000000000000000000000000000000000000000000000000000000001
                          1011111111111111111111111111100000000000000000000000000000000000001000000000000000000000000000000000000000000000000000000000000000000000000001
                          101                         100011000011000011000011000011000011001000000000000000000000000000000000000000000000000000000000000000000000000001
                          101                         100011000011000011000011000011000011001000000000000000000000000000000000000000000000000000000000000000000000000001
                          101                         100000000000000000000000000000000000001000000000000000000000000000000000000000000000000000000000000000000000000001
                          101                         100000000000000000000000000000000000001000000000000000000000000000000000000000000000000000000000000000000000000001
                          101                        1100111111111111111111111111111111111111000000000000000000000000000000000000000000000000000000000000000000000000001
111111111111111111111111111011111111111111111111111110001                                   1000000000000000000000000000000000000000000000000000000000000000000000000001
10000000001100000000000000000000000000000000000000000011                                    1000000000000000000000000000000000000000000000000000000000000000000000000001
1011000001110000000000000000000000110000000000000000001                                     1000000000000000000000000000000000000000000000000000000000000000000000000001
1001000000000000000000000000011001111111000000000000001111111111111                         1000000000000000000000000000000000000000000000000000000000000000000000000001
1111111110000000011100000000000011111111111100000000000000000000001                         1000000000000000000000000000000000000000000000000000000000000000000000000001
1000000000110000011101111111111110000000000000000000001111111110001                         1000000000000000000000000000000000000000000000000000000000000000000000000001
11110111111110011100000010000001100000001111111111111111       111                          1000000000000000000000000000000000000000000000000000000000000000000000000001
111101000000000000101001      11111111000000000000000001                                    1000000000000000000000000000000000000000000000000000000000000000000000000001
110000000101010000000001      10000000011111000000000001                                    1000000000000000000000000000000000000000000000000000000000000000000000000001
100000100000000000000001      10000001000000000000000001                                    1000000000000000000000000000000000000000000000000000000000000000000000000001
100010000000000000010101      10000000111111111111111111                                    1000000000000000000000000000000000000000000000000000000000000000000000000001
110000011101010111110111      11111110000000000000000001                                    1000000000000000000000000000000000000000000000000000000000000000000000000001
111101111111000111011111      10000000000000000000000001                                    1000000000000000000000000000000000000000000000000000000000000000000000000001
100000000000010000000001      10000011000000000000000001                                 1111000000000000000000000000000000000000000000000000000000000000000000000000001
10000000000001111111111111111111111111111111111111111101                                 1000100000000000000000000000000000000000000000000000000000000000000000000000001
10000000000000000000000000000000000000000000000000000001                                 1000100000000000000000000000000000000000000000000000000000000000000000000000001
10111111111111111111000000101000000000000000000000000001                                 1000100000000000000000000000000000000000000000000000000000000000000000000000001
10000000000000000000000010001000000000000000000000000001                                 1000100000000000000000000000000000000000000000000000000000000000000000000000001
111111111101111111111111111111111111111111111111111111111111111111111111111111111111111111101000000000000000000000000000000000000000000000000000000000000000000000000001
         101000000000000000000000000000000000000000000000000000000000000000000000000000000000000000000000000000000000000000000000000000000000000000000000000000000000001
         100000000000000000000000000000000000000000000000000000000000000000000000000000000000000000000000000000000000000000000000000000000000000000000000000000000000001
         101000000000000000000000000000000000000000000000000000000000000000000000000000000000000000000000000000000000000000000000000000000000000000000000000000000000001
         100000000000000000000000000000000000000000000000000000000000000000000000000000000000000000000000000000000000000000000000000000000000000000000000000000000000001
         101000000000000000000000000000000000000000000000000000000000000000000000000000000000000000000000000000000000000000000000000000000000000000000000000000000000001
         100000000000000000000000000000000000000000000000000000000000000000000000000000000000000000000000000000000000000000000000000000000000000000000000000000000000001
         101000000000000000000000000000000000000000000000000000000000000000000000000000000000000000000000000000000000000000000000000000000000000000000000000000000000001
         100000000000000000000000000000000000000000000000000000000000000000000000000000000000000000000000000000000000000000000000000000000000000000000000000000000000001
         101000000000000000000000000000000000000000000000000000000000000000000000000000000000000000000000000000000000000000000000000000000000000000000000000000000000001
         100000000000000000000000000000000000000000000000000000000000000000000000000000000000000000000000000000000000000000000000000000000000000000000000000000000000001
         101000000000000000000000000000000000000000000000000000000000000000000000000000000000000000000000000000000000000000000000000000000000000000000000000000000000001
         100000000000000000000000000000000000000000000000000000000000000000000000000000000000000000000000000000000000000000000000000000000000000000000000000000000000001
         101000000000000000000000000000000000000000000000000000000000000000000000000000000000000000000000000000000000000000000000000000000000000000000000000000000000001
         100000000000000000000000000000000000000000000000000000000000000000000000000000000000000000000000000000000000000000000000000000000000000000000000000000000000001
         101000000000000000000000000000000000000000000000000000000000000000000000000000000000000000000000000000000000000000000000000000000000000000000000000000000000001
         100000000000000000000000000000000000000000000000000000000000000000000000000000000000000000000000000000000000000000000000000000000000000000000000000000000000001
         101000000000000000000000000000000000000000000000000000000000000000000000000000000000000000000000000000000000000000000000000000000000000000000000000000000000001
         100000000000000000000000000000000000000000000000000000000000000000000000000000000000000000000000000000000000000000000000000000000000000000000000000000000000001
         101000000000000000000000000000000000000000000000000000000000000000000000000000000000000000000000000000000000000000000000000000000000000000000000000000000000001
         100000000000000000000000000000000000000000000000000000000000000000000000000000000000000000000000000000000000000000000000000000000000000000000000000000000000001
         101000000000000000000000000000000000000000000000000000000000000000000000000000000000000000000000000000000000000000000000000000000000000000000000000000000000001
         111111111111111111111111111111111111111111111111111111111111111111111111111111111111111111111111111111111111111111111111111111111111111111111111111111111111111