NO ./textures/wall1.jpg
SO ./textures/wall2.jpg
WE ./textures/wall3.jpg
EA ./textures/wall0.jpg

F 220,100,0
C 225,30,0

1111111111
10000000W1
1111111111