SO ../textures/ROCKSO.bmp
NO ../textures/ROCKNO.bmp

WE ../textures/ROCKWE.bmp
EA ../textures/ROCKEA.bmp

DO ./DOOR.jpg

F 250,0,0
C 0,250,0

        1111111111111111111111111
        1000000000110000000000001
        1011000001110000000000001
        1001000000H00000000000001
111111111000000001110000000000001
10000000001100000111L111111111111
1111T11111111RL11100000010000001
1111010000000000001010000001011
11000000010101000000000010001
1000001000000E000000000010001
10001000000000000001010010001
110000011101R1011111L11110001
11110111 11100000000011010001
11111111 11111111111111111111
