SP ../sprites/coin_ys_gold.png
[0;0]
[2.1;1.3]
[2.1;1.3]
[3,2;1.4]
[4,3;1,5]
[5.4;1,6]

W1 ../../textures/wall1.png
F ../../textures/floor_128.png
C ../../textures/ceil_128.png

1111111111
1000000001
1E00000001
1000000001
1111111111
