SO ROCKSO.bmp
NO ROC/KNO.bmp
WE ROCKWE.bmp
EA ROCKEA.bmp
C 20,25,40
F 20,20,25

11111
10001
10N01
10001
11111